5 10
**********
* *  *   *
* ****@* *
******   *
******#***
